55555555555555555555555555555555
13444444444444444444444444444431
14444444444444444444444444444441
14444444444441444441444444444441
14444444444441444441444444444441
14444444444441444441444444444441
14444444444441444441444444444441
55555555555555444445555555555555
14444444444444444444444444444441
14444444444444444444444444444441
14444444444444444444444444444441
14444444444444444444444444444441
14444444444444444444444444444441
14444444444444444444444444444441
14444444444444444444444444444441
14444444444444444444444444444441
14444444444444444444444444444441
14444444444444444444444444444441
14444444444444444444444444444441
14444444444444444444444444444441
14444444444444444444444444444441
14444444444444444444444444444441
14444444444444444444444444444441
14444444444444444444444444444441
14444444444444444444444444444441
14444444444444444444444444444441
14444444444444444444444444444441
14444444444444444444444444444441
14444444444444444444444444444441
14444444444444444444444444444441
13444444444444444444444444444431
55555555555555555555555555555555