11111111111111111111111111111111
1                              1     
1                              1     
11111111111          11111111111                         
1                              1 
1                              1
1                              1
0           222222             0 
0           222222             0 
1                              1
1                              1    
1                              1     
1                              1     
1                              1     
1                              1 
1                              1     
11111111111111111111111111111111
