25555555555555555555555555555558
13444444444444444444444444444431
14444444444444444444444444444441
14444444444441444441444444444441
14444444444441444441444444444441
14444444444441444441444444444441
14444444444441444441444444444441
15555555555557444446555555555551
14444444444444444444444444444441
14444444444444444444444444444441
14444444444444444444444444444441
14444444444444444444444444444441
14444444444444444444444444444441
14444444444444444444444444444441
14444444444444444444444444444441
14444444444444444444444444444441
14444444444444444444444444444441
14444444444444444444444444444441
14444444444444444444444444444441
14444444444444444444444444444441
14444444444444444444444444444441
14444444444444444444444444444441
14444444444444444444444444444441
14444444444444444444444444444441
14444444444444444444444444444441
14444444444444444444444444444441
14444444444444444444444444444441
14444444444444444444444444444441
14444444444444444444444444444441
14444444444444444444444444444441
13444444444444444444444444444431
65555555555555555555555555555557